1111111111
1000P000C1
1111110001
1E00010001
1111000001
1111111111