11111111111
1C000P000C1
11111001111
1C0000000E1
11111111111
