1111111111
10C0PC00C1
1111110001
1E00010C01
1111000001
1111111111