111111111111111
1C000P0001C1001
111110001CC1101
1C0000000000E11
11111C111111111
111111111111111
111111111111111
