11111111111111111
1P111C1C010100011
10000000000000011
11111011111111111
11111011111111111
100000000000000C1
10000010000101111
10111110010100001
10000000010000111
11100111111111111
10000010000101111
10000000000101111
100000100000E1111
11111111111111111
10000111111111111
11111111111111111