11111111111111111
1P111C1C0101000C1
10000010000101111
10111110010100001
100C00000100001E1
11111111111111111