11111111111111111
1P111C1C0101000C1
10000010000101111
10111110010100001
100C00000100001E1
11100111111111111
100000100001C1111
10000000000101111
100000100000C1111
11111111111111111