1111111111
1P111111E1
1011111111
1011111101
1000000001
1C00111111
1111111111
