111111111111
1C0EE00CP001
111111111111
