11111111
10000001
1P000E01
111C1111
11101111
