111111111111
1P00000000P1
100000000001
100000000001
100000000001
100000000001
1C00000000E1
111111111111