11111111111
10000000001
11111111111

11111111111
1P0000000C1
11111111011
1E000000011
11111111111